1111111
1P000C1
1011101
1C001E1
1111111