1111111
1P00001
1101101
1C001E1
1111111