1111111
1P00001
1110111
1C000E1
1111111