111111111111111
1P00000000000E1
111011111110111
1C0000000C00001
101111101111101
1C00000000C0001
111110111011111
1C0000000000C01
100011111110001
111111111111111