111111111111111111111111111111111111111111111111111111111111111111111111111111111111111111111111111
1P0000000000000000000000000000000000000000000000000000000000000000000000000000000000000000000000001
100000000000000000000000000000000000000000000000000000000000000000000000000000000000000000000000001
10000000C000000000000000000000000000000000000000000000000000000000000000000000000000000000000000001
100000000000000000000000000000000000000000000000000000000000000000000000000000000000000000000000001
100000000000000000000000000000000000000000000000000000000000000000000000000000000000C00000000000001
100000000000000000000000000000000000000000000000000000000000000000000000000000000000000000000000001
100000000000000000000000C00000000000000000000000000000000000000000000000000000000000000000000000001
100000000000000000000000000000000000000000000000000000000000000000000000000000000000000000000000001
100000000000000000000000000000000000000000000000000000000000000000000000000000000000000000000000001
10000000000000000000000000000000000000000000000000000000000000000000000000000000000000000000000C001
100000000000000000000000000000000000000000000000000000000000000000000000000000000000000000000000001
100000000000000000000000000000000000000000000000000000000000000000000000000000000000000000000000001
100000000000000000000000000000000000000000000000000000000000000000000000000000000000000000000000001
100000000000000000000000000000000000000000000000000000000000000000000000000000000000000000000000001
1C0000000000000000000000000000000000000000000000000000000000000000000000000000000000000000000000011
100000000000000000000000000000000000000000000000000000000000000000000000000000000000000000000000001
100000000000000000000000000000000000000000000000000000000000000000000000000000000000000000000000001
1C0000000000000000000000000000000000000000000000000000000000000000000000000000000000000000000000011
1C0000000000000000000000000000000000000000000000000000000000000000000000000000000000000000000000011
1C0000000000000000000000000000000000000000000000000000000000000000000000000000000000000000000000011
1C0000000000000000000000000000000000000000000000000000000000000000000000000000000000000000000000011
1C0000000000000000000000000000000000000000000000000000000000000000000000000000000000000000000000011
100000000000000000000000000000000000000000000000000000000000000000000000000000000000000000000000011
100000000000000000000000000000000000000000000000000000000000000000000000000000000000000000000000E11
111111111111111111111111111111111111111111111111111111111111111111111111111111111111111111111111111