111111111111111111111111111111
1P00000000000000000000000000E1
111111011111101111110111111111
1C00001C0000000000C001C00000C1
100001111110001111100011110001
1C0000C0000000C0000C00000C0001
100001111110001111100011110001
1C0000000C000000000C00000C0001
111111011111101111110111111111
1C00001C0000000000C001C00000C1
100001111110001111100011110001
1C0000C0000000C0000C00000C0001
111111011111101111110111111111
1C0000000000000000000000000C01
111111111111111111111111111111